9 16
1 6 6 6 6 6 6 12 12 6 6 6 6 6 6 2
5 0 0 0 0 0 0 12 12 0 0 0 0 0 0 7
5 10 11 11 11 11 11 12 12 11 11 11 11 11 11 7
5 9 12 12 12 12 12 12 12 12 12 12 12 12 12 7
5 9 12 12 12 12 12 12 12 12 12 12 12 12 12 7
5 9 12 12 12 12 12 12 12 12 12 12 12 12 12 7
5 9 12 12 12 12 12 12 12 12 12 12 12 12 12 7
5 9 12 12 12 12 12 12 12 12 12 12 12 12 12 7
3 8 8 8 8 8 8 8 8 8 8 8 8 8 8 4
