18 64
1 6 6 6 6 6 22 9 12 23 6 6 6 6 6 2 1 6 6 6 6 6 6 6 6 6 6 6 6 6 6 2 1 6 6 6 6 6 6 6 6 6 6 6 6 6 6 2 1 6 6 6 6 6 6 6 6 6 6 6 6 6 6 2
5 0 0 0 0 0 0 9 12 0 0 0 0 0 0 7 5 0 0 0 0 0 0 0 0 0 0 0 0 0 0 7 5 0 0 0 0 0 0 0 0 0 0 0 0 0 0 7 5 0 0 0 0 0 0 0 0 0 0 0 0 0 0 7
5 10 11 11 11 11 11 12 12 11 11 11 11 11 11 26 22 10 11 11 11 11 11 11 11 11 11 11 11 11 11 7 5 10 11 11 11 11 11 11 11 11 11 11 11 11 11 26 22 10 11 11 11 11 11 11 11 11 11 11 11 11 11 7
5 9 12 12 12 12 12 12 12 12 12 12 12 12 12 0 0 9 12 12 12 12 12 12 12 12 12 12 12 12 12 7 5 9 12 12 12 12 12 12 12 12 12 12 12 12 12 0 0 9 12 12 12 12 12 12 12 12 12 12 12 12 12 7
5 9 12 12 12 12 12 12 12 12 12 12 12 12 12 11 11 12 12 12 12 12 12 12 12 12 12 12 12 12 12 7 5 9 12 12 12 12 12 12 12 12 12 12 12 12 12 11 11 12 12 12 12 12 12 12 12 12 12 12 12 12 12 7
5 9 12 12 12 12 12 12 12 12 12 12 12 12 12 12 12 12 12 12 12 12 12 12 12 12 12 12 12 12 12 7 5 9 12 12 12 12 12 12 12 12 12 12 12 12 12 12 12 12 12 12 12 12 12 12 12 12 12 12 12 12 12 7
5 9 12 12 12 12 12 12 12 12 12 12 12 12 12 25 24 9 12 12 12 12 12 12 12 12 12 12 12 12 12 7 5 9 12 12 12 12 12 12 12 12 12 12 12 12 12 25 24 9 12 12 12 12 12 12 12 12 12 12 12 12 12 7
5 9 12 12 12 12 12 12 12 12 12 12 12 12 12 7 5 9 12 12 12 12 12 12 12 12 12 12 12 12 12 7 5 9 12 12 12 12 12 12 12 12 12 12 12 12 12 7 5 9 12 12 12 12 12 12 12 12 12 12 12 12 12 7
3 8 8 8 8 8 24 9 12 25 8 8 8 8 8 4 3 8 8 8 8 8 24 9 12 25 8 8 8 8 8 4 3 8 8 8 8 8 8 8 8 8 8 8 8 8 8 4 3 8 8 8 8 8 24 9 12 25 8 8 8 8 8 4
1 6 6 6 6 6 22 9 12 23 6 6 6 6 6 2 1 6 6 6 6 6 22 9 12 23 6 6 6 6 6 2 1 6 6 6 6 6 6 6 6 6 6 6 6 6 6 2 1 6 6 6 6 6 22 9 12 23 6 6 6 6 6 2
5 0 0 0 0 0 0 9 12 0 0 0 0 0 0 7 5 0 0 0 0 0 0 9 12 0 0 0 0 0 0 7 5 0 0 0 0 0 0 0 0 0 0 0 0 0 0 7 5 0 0 0 0 0 0 9 12 0 0 0 0 0 0 7
5 10 11 11 11 11 11 12 12 11 11 11 11 11 11 7 5 10 11 11 11 11 11 11 11 11 11 11 11 11 11 26 22 10 11 11 11 11 11 11 11 11 11 11 11 11 11 26 22 10 11 11 11 11 11 11 11 11 11 11 11 11 11 7
5 9 12 12 12 12 12 12 12 12 12 12 12 12 12 7 5 9 12 12 12 12 12 12 12 12 12 12 12 12 12 0 0 9 12 12 12 12 12 12 12 12 12 12 12 12 12 0 0 9 12 12 12 12 12 12 12 12 12 12 12 12 12 7
5 9 12 12 12 12 12 12 12 12 12 12 12 12 12 7 5 9 12 12 12 12 12 12 12 12 12 12 12 12 12 11 11 12 12 12 12 12 12 12 12 12 12 12 12 12 12 11 11 12 12 12 12 12 12 12 12 12 12 12 12 12 12 7
5 9 12 12 12 12 12 12 12 12 12 12 12 12 12 7 5 9 12 12 12 12 12 12 12 12 12 12 12 12 12 12 12 12 12 12 12 12 12 12 12 12 12 12 12 12 12 12 12 12 12 12 12 12 12 12 12 12 12 12 12 12 12 7
5 9 12 12 12 12 12 12 12 12 12 12 12 12 12 7 5 9 12 12 12 12 12 12 12 12 12 12 12 12 12 25 24 9 12 12 12 12 12 12 12 12 12 12 12 12 12 25 24 9 12 12 12 12 12 12 12 12 12 12 12 12 12 7
5 9 12 12 12 12 12 12 12 12 12 12 12 12 12 7 5 9 12 12 12 12 12 12 12 12 12 12 12 12 12 7 5 9 12 12 12 12 12 12 12 12 12 12 12 12 12 7 5 9 12 12 12 12 12 12 12 12 12 12 12 12 12 7
3 8 8 8 8 8 8 8 8 8 8 8 8 8 8 4 3 8 8 8 8 8 8 8 8 8 8 8 8 8 8 4 3 8 8 8 8 8 8 8 8 8 8 8 8 8 8 4 3 8 8 8 8 8 8 8 8 8 8 8 8 8 8 4
